00000000000000011110
00111111221111110011
00100000900000000002
00100000900000000992
00100900990900099901
00200900009999990001
00299900099000000001
00200990000000000011
00100099000000000110
00100009900000001100
00100000900009001000
00100009900099901000
00100009000090901000
00110009999900992000
00010009099088002000
00010009090888801000
00011009099888001000
00001119009880011000
00000012219001110000
00000000012211000000
