11111111111111100001
11000000110000001100
11011111111111111111
11011111111111111111
11011111111111111110
11111111111111111110
11111111111111111110
11111111111111111100
11011111111111111001
11011111111111110011
11011111111111110111
11011111111111110111
11011111111111110111
11001111111111111111
11101111111111111111
11101111111111110111
11100111111111110111
11110001111111100111
11111101101110001111
11111111101100111111
