00000000000000000000
01112112121111211100
01009109990100900100
01099100900100901100
02990100900100999200
01090009900199900100
01990999000190000100
02990900990190000100
01090900990191111100
01090900000090099200
01090999909999990100
01090000999000090100
01090000090099099100
02999099090099009200
01009099090000000100
01009000091111111100
02999990099999000100
01990099990009000100
01221121121112111100
00000000000000000000
