00000000000000000000000000000000000000000000000000
00000000000000000000000000000000000000000000000000
00011111111111121111121111121111110000000000000000
00020000000000000100000000000000011121111111100000
00020000000000000110000001000999990000000000110000
00029999900000000010000011000900099900000000010000
00020000999990000010000010000900000900099900011000
00020000000099000010000011009000100900009900001000
00022000000009900011111111009000100900009900001000
00111100000000990000000000009000100090000000001000
00000111111000099000000000009000100099999900001100
00000000001100000990000000099000100090000990000100
00000000000100900099999999990000100090000099900110
00000000000200990000000000000000100990010000990010
00000000000100990000000000000000100900010000090020
00000000000111111110000000000000100900010000090010
00000000000100000011111111111111000900010000090010
00000000000200000010000000000000000900110000090010
00000000000299900010000000000000000900100000090010
00000000000100900010000000000000000900100000900100
00000000000100990010000000000000009900100000900100
00000000000100099900000000000000099000100000900100
00000000000110000990000000999999990000100000900200
00000000000010009999999999900000000000100000900100
00000000000010000910000000000999900000100000901100
00000000000011000910000000000999900000100009901000
00000000000001000910000000000999990000100009001000
00000000000001000910000000000000000000100009002000
00000000000001000911111111111100000000100009001000
00000000000011000910000000000111111111100099001000
00000000000011111910000000000000000000000090011000
00000000000010000910000009990000000000000090010000
00000000000100009910009999999999900000000990010000
00000000000100009010009999999999900000000900020000
00000000000299999010099999999999900000009900010000
00000000000100009010099999999999990000009000110000
00000000001111109110009999999999990000009000100000
00000000011000009010000099999999000000009000200000
00000000110009999010000000000000000000099000100000
00000000299999090010000000000000000000090000100000
00000000110000099000000000000000000000990000100000
00000000012999990000000000000000000009900000200000
00000000001100009999999999999000000099000000100000
00000000000110000900000000009999000090000000100000
00000000000011000900000000000009900990000000100000
00000000000001100900000000000000999000000000100000
00000000000000111221110000000000000000000001100000
00000000000000000000011111000000000000000011000000
00000000000000000000000001112111221121121110000000
00000000000000000000000000000000000000000000000000
