44444444444444444444444444444444
44444444444444444444444112221114
44444444444444444444444100000014
44444444444444444444444100000014
44444444444444444444444100000014
44444444444444444444444100000014
41111111111111111111111100000014
42000000000000000000000000000024
42000000000000000000000000000024
42000000000000000000000000000024
41033333333330003333333333000014
41000000000000000000000000000014
41033333333330003333333333000014
42000000000000000000000000000024
42033333333330003333333333000024
41000000000000000000000000000014
41033333333330003333333333000314
41000000000000000000000000000014
42033333333330003333333333000024
42000000000000000000000000000024
41033333333330003333333333000014
41000000000000000000000000000014
42033333333330003333333333000024
42000000000000000000000000000024
41033333333330003333333333000014
41000000000000000000000000000014
41033333333330003333333333000014
42000000000000000000000000000024
42033333333330003333333333000024
41000000000000000000000000000014
41000033333330000000003333000014
41000000000000000000000000000314
42000000000000000000000000000024
42000000000000000000000000000024
41000000000000000000000000000014
41000000000000000000000000000014
41000000000000000000000000000014
42000000000000000000000000000024
42000000000000000000000000000024
42000000000000000000000000000024
41000000000000000000000000000014
41111111000000000000000011111114
41000000000000000000000000000014
41000000000000000000000000000014
42000000000000000000000000000024
42000000111111111111111100000024
42000000111111111111111100000024
42000000000000000000000000000024
41000000000000000000000000000014
41000000000000000000000000000014
41000111001111111111111100111114
42000100000000001000000000000014
42000133333310031000133333333314
41111111111111111111111111111114
44444444444444444444444444444444
